#########################################
#   #       #             #             #
### # # ##### ########### # ########### #
# # # #     #     #     # #   #     # # #
# # # ##### ##### ##### # ### ### # # # #
# # #     #     #       #         #   # #
# # ##### # ########### ######### ##### #
#   #   # # #     #         #   # #     #
# ### ### # # ### # ######### # ### ### #
# #       #   #   # #   #     #     #   #
# ############# ### # # # ########### ###
#     #       # #   # # #   #       #   #
##### # ##### # # ##### ### ####### ### #
#     #   # # # #         # #       #   #
# ####### # # # ######### # # ####### ###
# #     # #   #     # #   # #         # #
# ### # # # ### ### # # ### # ######### #
#   # #   #     # #   # #   #   #     # #
### # ##### ##### ### # # ##### ### # # #
#   #   #   #   #     # #   # #     # # #
# ##### # ### # ####### ### # ####### # #
#     # # #   #   #     #   #   #     # #
##### # ### ##### # ##### ### ### ##### #
#     # #   #   #     #   #   #   #     #
# ##### # ### # ####### ### ### ### ### #
# #   #     # #       # #   #   #   #   #
# ### # ##### ####### # # ### ### # ### #
#   #   #     #       # #     #   #   # #
### ### # ####### ##### # ########### # #
# #   # #       #       #         #   # #
# ### # ####### ################# # ### #
#   # #       # #       #     # # # #   #
# # # ####### # ### ### # ### # # # # ###
# #   #       #   #   #   #     #   # # #
# ####### ####### ### ######### ##### # #
# #     # #       #   #       #     #   #
# # ### # # ####### ### ##### ######### #
# # # # # #   # #   #   #   # #       # #
# # # # ##### # # # # ### # # # ### ### #
#   #         #   #       # #     #     #
#########################################